6,6,6,6,6,6,6,6,6,6,6,6,6,6,6,6,6,6,6,6,6,6,6,6,6
6,0,0,0,0,0,0,0,0,0,0,0,0,0,0,0,0,0,0,0,0,0,0,0,6
6,0,1,1,1,1,1,1,0,0,0,1,1,1,0,0,2,2,0,0,0,0,0,0,6
6,0,0,2,2,1,1,1,1,1,1,1,1,1,0,0,2,2,4,4,4,4,0,0,6
6,0,0,0,0,0,1,1,0,0,0,1,1,1,0,0,2,2,4,4,7,4,0,0,6
6,0,0,0,0,0,1,0,0,0,0,0,0,1,0,0,2,2,4,4,4,4,0,0,6
6,0,0,0,0,0,1,0,0,0,0,0,0,1,0,0,2,2,4,4,4,4,0,0,6
6,0,0,0,0,0,1,0,0,0,0,1,1,1,0,0,2,2,0,0,0,0,0,0,6
6,0,0,0,0,0,1,0,0,0,0,1,1,1,0,0,0,0,0,0,0,0,0,0,6
6,0,0,0,0,4,4,4,4,1,1,1,1,1,0,0,0,2,2,0,0,0,0,0,6
6,0,0,0,0,4,4,4,4,0,0,1,1,0,0,0,0,2,2,2,2,0,0,0,6
6,4,4,4,4,4,5,4,4,0,0,0,1,0,0,0,0,0,2,2,2,0,0,0,6
6,0,0,0,0,4,4,4,4,0,0,0,1,0,0,0,0,0,2,2,2,2,2,0,6
6,0,0,0,0,4,4,4,4,0,0,0,1,1,1,1,0,0,0,0,2,2,2,0,6
6,0,0,0,0,0,0,1,0,0,0,0,0,1,1,1,1,1,0,0,0,1,0,0,6
6,0,0,0,0,0,0,1,0,0,0,0,0,1,1,1,1,1,1,1,1,1,0,0,6
6,0,0,0,0,2,0,1,0,0,0,0,0,0,0,0,1,1,0,0,1,1,0,0,6
6,0,0,0,0,2,1,1,0,0,2,2,0,0,0,0,0,1,0,0,2,2,0,0,6
6,0,0,0,0,2,2,2,0,0,0,2,2,0,0,4,4,4,4,0,2,2,0,0,6
6,0,0,0,0,2,2,2,0,0,0,0,2,0,0,4,4,7,4,0,2,2,2,0,6
6,0,0,0,0,2,2,2,0,0,0,0,0,0,0,4,4,4,4,0,0,0,2,0,6
6,0,0,0,0,0,0,0,0,0,0,0,0,0,0,4,4,4,4,0,0,0,0,0,6
6,0,0,0,0,0,0,0,0,0,0,0,0,0,0,0,0,0,0,0,0,0,0,0,6
6,6,6,6,6,6,6,6,6,6,6,6,6,6,6,6,6,6,6,6,6,6,6,6,6
